LMMMMMMMMMMMMMMMMMMMMMMMMMMMMMMMMMMR
----------C------z----------C-----
----GGGGGGGGG--GGGG----GGGG-------
-------C-------------------C------
----z--GGG---------GGGG--z-------
--GGGGG---------C-------------GGG-
-------------GGGGG----z-----------
------z----C------------------C---
----GGGG---GGG------GG--GGGGGGG---
--C------------------------C----W-
P----------------------------------
GGGGGGGGGGGGGGGGGGGGGGGGGGGGGGGGG-
